%%%%%%%%%%%%%%%%%%%%%%%%%%%%%%%%%%%%%%%%%
%       %     %       % %     % %   % % %
% % %%% % %%% %%% %%%%% % %%%%% % %%% % %
% %   % %   %   %   %       % %         %
%%%%%%% %%% %%% % % % % % %%% % %%% % % %
%   %         %   % % % % %     % % % % %
% %%% % %%% %%%%%%% % %%% % %%%%% % %%% %
% %   %   %   % %   %   %   % %     %   %
% % %%% % %%%%% % %%%%% %%%%% %%% %%%%%%%
%   %   % %     % %     %   %       %   %
%%% %%%%%%%%% %%% % %%% %%% %%%%%%% %%% %
%     % %   %     % % % % %         %   %
%%%%% % % %%%%%%% % % %%% %%% %%% %%% % %
% %   %     %   %   %           % %   % %
% % %%% % %%% %%%%%%%%% %%%%%%% %%% %%%%%
%       %     %       % %     %   %     %
% %%%%%%%%% %%%%% %%%%% %%%%% % % %%% %%%
% %   % %         % % %   %   % %     % %
% % % % %%%%% %%%%% % %%% % % %%% % %%%%%
% % %       %   % %     % %       % % % %
% % %%% % %%% %%% %%%%% % % %%% % %%% % %
%   % % % %       %   % % %   % % %     %
%%% % %%%%%%%%% %%% %%% % %%% %%%%%%% %%%
%     % %   %           %   %           %
%%% % % % %%% %%% %%%%% % % %%%%%%%%%%% %
%   % %   %     %   %   % %       %     %
%%% %%% %%%%% % %%% % %%% % %%%%% %%% % %
%     %   %       % %   % % % % %     % %
% % % % %%%%% % %%%%%%%%%%% % % %%%%%%% %
% % % %     % %           %   %       % %
% %%% %%% % %%%%% % %%%%% %%% % % %%%%%%%
%   % %   %       % %   %   %   %     % %
% %%%%%%% %%%%% %%%%% % %%% %%% %%% % % %
%   %     %   % %     %       % %   %   %
% % %%%%%%%%%%% % % %%%%% % % % %%%%% %%%
% %   %       % % %     % % % %   %     %
% %%%%% % %%%%%%% %%% %%%%%%% %%% % %%% %
%   %   %     %   %   %     % %   % % % %
%%%%% % %%% %%%%% %%%%% %%% % %%% % % %%%
%.    % %                 % %   % %    P%
%%%%%%%%%%%%%%%%%%%%%%%%%%%%%%%%%%%%%%%%%