%%%%%%%%%%%%%%%%%%%%%%%%%%%%%%%%%%%%%
%                    P%             %
%                     %             %
%                     %             %
%                     %             %
%                     %             %
%       %%%%%%%%%%%%%%%    %        %
%                          %        %
%                          %        %
%                          %        %
%                          %        %
%    %%%%%       %%%%%%%%%%%        %
%                          %        %
%        %                          %
%        %                          %
%        %                          %
%        %                          %
%        %                          %
%        %.                         %
%%%%%%%%%%%%%%%%%%%%%%%%%%%%%%%%%%%%%