%%%%%%
%P %.%
% .  %
%    %
%   .%
%%%%%%