%%%%%%%%%
%P  %  .%
%   %   %
%   %   %
%       %
%       %
%       %
%.      %
%%%%%%%%%